EA ./textures/spy-x-family.xpm42
NO ./textures/yellow-brick-texture.xpm42 uyguigiugjkh

WE ./textures/Sponge-WallPaper.xpm42

jdfkhdsfjksd

SO ./textures/NyanCat.xpm42

C 200 ,  45  	,       45
F 0 ,   180  , 50

        1111111111111111111111111
        10000000001100000N0000001
        1011000001110000000000001
        1001000000000000000000001
111111110011000001110000000000001
100000000011000001110111111111111
11110111111111011100000010001
11110111111111011101010010001
11000000110101011100000010001
100000     000001100000111111
10000000000000001101010000001
1100000111010101111101111000111
11110111 1110101 101111010001
11111111 1111111 111111111111