EA ./textures/spy-x-family.xpm42
NO ./textures/yellow-brick-texture.xpm42 uyguigiugjkh

WE ./textures/Sponge-WallPaper.xpm42

jdfkhdsfjksd

SO ./textures/NyanCat.xpm42

C 200 , 45 , 45
F 0,180,50


0111111011111111
010000111000N001
0100000000111111
0111111010000001
        11111111