EA ./textures/spy-x-family.xpm42
NO ./textures/yellow-brick-texture.xpm42

WE ./textures/Sponge-WallPaper.xpm42

jdfkhdsfjksd

SO ./textures/NyanCat.xpm42

F 255,    255,     254
C 0, 10,    		0

1111111
1N00001
1000001
1000001
1111111