EA ./textures/spy-x-family.xpm42
NO ./textures/yellow-brick-texture.xpm42

WE ./textures/Sponge-WallPaper.xpm42

SO ./textures/NyanCat.xpm42

F 0, 180,40
C 0, 20, 160

        1111111111111111111111111
        1000000000110000000000001
        1011000001110000000000001
        1001000000000000000W00001
111111110011000001110000000000001
100000000011000001110111111111101
11110111111111011100000010001
11110111111111011101010010001
11000000110101011100000010000
100000     000001100000111111
10000000000000001101010000001
1100000111010101111101111000111
11110111 1110101 101111010001
11111111 1111111 111111011111